R 2222 2222

NO ./north.xpm
SO ./south.xpm
WE ./west.xpm
EA ./east.xpm
S ./sprite.xpm

F 222,122,2
C 222,222,2

        1111111111111111111111111
        1222222222222222222222221
        1211222221112222222222221
        1221222222222222222222221
111111111211222221112222222222221
122222222211222221112111111111111
11112111111111211122222210201
11112111111111211121212210001
11222222112121211122222212001
12222222222222221122222210001
12222222222222221121212210021
11222221112121211111211110N0111
11112111 1112121 121111210001
11111111 1111111 111111111111
